%%%%%%%%%%%%%%
%P          G%
%            %
%            %
%            %
%            %
%            %
%G           %
%%%%%%%%%%%%%%
% % %%%%%%%%%%
%%%%%%%%%%%%%%