%%%%%%%%%%%%%%
%G           %
%%%%%%       %
%..       %%%%
%           G%
%G           %
%%%%         %
%           P%
%%%%%%%%%%%%%%
% % % %%%%%%%%
%%%%%%%%%%%%%%
