%%%%%%%%%%%%%%
%G          P%
%            %
%            %
%            %
%            %
%            %
%           G%
%%%%%%%%%%%%%%
% % %%%%%%%%%%
%%%%%%%%%%%%%%