%%%%%%%%%%%%%%
%G           %
%%%          %
%            %
%G           %
%    G       %
%            %
%           P%
%%%%%%%%%%%%%%
% % % %%%%%%%%
%%%%%%%%%%%%%%
