%%%%%%%%%%%%%%
%G          G%
%            %
%            %
%            %
%            %
%            %
%           P%
%%%%%%%%%%%%%%
% % %%%%%%%%%%
%%%%%%%%%%%%%%
