%%%%%%%%%%%%%%
%           P%
%            %
%            %
%      G     %
%            %
%            %
%G           %
%%%%%%%%%%%%%%
% % %%%%%%%%%%
%%%%%%%%%%%%%%