%%%%%%%%%%%%%%
%P          G%
%            %
%            %
%            %
%            %
%            %
%G          G%
%%%%%%%%%%%%%%
% % %%%%%%%%%%
%%%%%%%%%%%%%%