%%%%%%%%%%%
%  P%%%%%%%
%G  %%%%%%%
%%%%%%%%%%%
% %%%%%%%%%
%%%%%%%%%%%
